{
    "char_to_int": {
        "<BLANK>": 0,
        " ": 1,
        ",": 2,
        ".": 3,
        ":": 4,
        "?": 5,
        "D": 6,
        "E": 7,
        "M": 8,
        "a": 9,
        "c": 10,
        "d": 11,
        "e": 12,
        "g": 13,
        "h": 14,
        "i": 15,
        "l": 16,
        "n": 17,
        "o": 18,
        "p": 19,
        "r": 20,
        "s": 21,
        "t": 22,
        "v": 23,
        "ं": 24,
        "ः": 25,
        "अ": 26,
        "आ": 27,
        "इ": 28,
        "ई": 29,
        "उ": 30,
        "ऊ": 31,
        "ऋ": 32,
        "ए": 33,
        "ऐ": 34,
        "ऑ": 35,
        "ओ": 36,
        "औ": 37,
        "क": 38,
        "ख": 39,
        "ग": 40,
        "घ": 41,
        "ङ": 42,
        "च": 43,
        "छ": 44,
        "ज": 45,
        "झ": 46,
        "ञ": 47,
        "ट": 48,
        "ठ": 49,
        "ड": 50,
        "ढ": 51,
        "ण": 52,
        "त": 53,
        "थ": 54,
        "द": 55,
        "ध": 56,
        "न": 57,
        "प": 58,
        "फ": 59,
        "ब": 60,
        "भ": 61,
        "म": 62,
        "य": 63,
        "र": 64,
        "ल": 65,
        "ळ": 66,
        "व": 67,
        "श": 68,
        "ष": 69,
        "स": 70,
        "ह": 71,
        "ा": 72,
        "ि": 73,
        "ी": 74,
        "ु": 75,
        "ू": 76,
        "ृ": 77,
        "े": 78,
        "ै": 79,
        "ो": 80,
        "ौ": 81,
        "्": 82,
        "ॐ": 83,
        "𑍍": 84,
        "𑘎": 85,
        "𑘚": 86,
        "𑘡": 87,
        "𑘦": 88,
        "𑘭": 89,
        "𑘲": 90,
        "𑘴": 91,
        "𑘻": 92,
        "𑘽": 93
    }
}